####################
#            .     #
#       . $     $  #
#     $      $     #
#   ###########    #
#  @         $     #
#  $ .         .   #
#        .     .   #
####################